XXXXXXXXXXXXXXXXXXXXXXXXXXXXXXXXXXXXXX
X____XXX_____X___X____X_____X________X
XX_X_X___XXX_XXX_X_XXXX_X_X_X_X_XXX_XX
X__X______X___________X_X_X_X_X_X_X__X
X_XX_XXX__X__X_XXXXXXXX_X_X_________XX
X__X_X_X__X__X_X______X_X_XX_X_X__X__X
X_XX_X_X_XXX_X_X_XXXX_X_X__X_X_XXXX_XX
X__XXX_X___X_X_X_X__X_X_XX_XXX_XX____X
XXXX_X_XXX_X_X_X_XX_X_X__X_X___X_XXXXX
_____________X_X_XX_XXXX_X_X_XXX______
X_XXXXXXX_XX_X_X______XX_XXX_X___XXX_X
X_____X_X_X______XXX___X_X___X_X___X_X
XXX_XXX___X__XX__X___XXX_X_XXXXXXXXX_X
X___X___XXXX__X_XXXXXX___X_X___X___X_X
XXX_X_X_______X_X______X_X_X_X_X_XXX_X
X___XXXXXXXXX_X_X_X_XXXXXX_X_X_______X
X__XX_______X_XXX_XXX______X__XXX_XX_X
XX__X_XXXXX_X_X___X___X_XXXXX__X__X__X
XX_XX_X_____X_X_XXX_XXX_X___XX_XXXXXXX
X_____XXXXXXX_X_X___X___X_X__X__X____X
X_XXXXXX______X_XXXXX_X_XXXX_XX_X_XX_X
X______X_X_XXXX_X___X_X___________X__X
X_XXXX_X_XXX______XXX_XXXXXXXXXXX_X_XX
X_X____X_____XX_X___X_____X_______X__X
XXXXXXXXXXXXXXXXXXXXXXXXXXXXXXXXXXXXXX
