XXXXXXXXXXXXXXXXXXXXXXXXXXXXXXX
X                                                          X
X                                                          X
X                                                          X
X                                                          X 
X                                                                                                                  X 
X                                                                                                                  X 
X                                                                                                                  X 
X                                                                                                                  X 
X                                                                                                                  X 
X                                                                                                                  X 
X                                                                                                                  X 
X                                                                                                                  X 
X                                                                                                                  X 
X                                                                                                                  X 
X                                                                                                                  X 
X                                                                                                                  X 
XXXXXXXXXXXXXXXXXXXXXXXXXXXXXXXXXXXXXXXXXXXXXXXXXXXXXXXXXXX
